[
    {
        "l_name": "50",
        "stations": [
            "00000",
            "00001",
            "00002",
            "00003",
            "00004",
            "00005",
            "00006",
            "00007",
            "00008",
            "00009",
            "00010",
            "00011",
            "00012",
            "00013",
            "00014",
            "00015",
            "00016",
            "00017",
            "00018",
            "00019"
        ]
    },
    {
        "l_name": "51",
        "stations": [
            "00000",
            "00001",
            "00002",
            "00003",
            "00004",
            "00005",
            "00006",
            "00007",
            "00008",
            "00009",
            "00010",
            "00011",
            "00020",
            "00021",
            "00022",
            "00023",
            "00024",
            "00025",
            "00026"
        ]
    },
    {
        "l_name": "52",
        "stations": [
            "00027",
            "00028",
            "00026",
            "00029",
            "00030",
            "00031",
            "00032",
            "00009"
        ]
    },
    {
        "l_name": "53",
        "stations": [
            "00033",
            "00034",
            "00035",
            "00036",
            "00037",
            "00038",
            "00012",
            "00020",
            "00021",
            "00022",
            "00023",
            "00024",
            "00025",
            "00026"
        ]
    }, {
        "l_name": "54",
        "stations": [
            "00026",
            "00025",
            "00024",
            "00023",
            "00022",
            "00021",
            "00020",
            "00012",
            "00013",
            "00014",
            "00015",
            "00016",
            "00017",
            "00018",
            "00019"
        ]
    }
]